R 800 600
NO ./pics/redbrick.xpm
SO ./pics/eagle.xpm
WE ./pics/WALL93.xpm
EA ./pics/WALL20.xpm
S ./pics/barrel.xpm
F 0,255,0
C 0,0,225




        1111111111111111111111111
        1000000000112220000000S01
        1011000001110000002000001
        1001000000000000000000001
111111111011000001110000000000001
100000000011000001110111111111111
11110111111111011100000010001
11110111111111011101010010001
11000000110101011100000010001
10002000000000001100000010001
10000000000000001101010010001
110000011101010111110111100111
11110111 1110101 101111010001
11111111 1111111 111111111111